000000000000000000000
111111111111111111110
111111111111111111110
000000000000000000110
011111111111111111110
011111111111111111110
011000000000000000000
011111111111111111111
011111111111111111111
000000000000000000000
000000000000000000000
000000000000000000000
000000000000000000000


path:1:0:E,1:19:S,5:19:W,5:2:S,7:2:E,7:20:E
path:2:0:E,2:18:S,4:18:W,4:1:S,8:1:E,8:20:E

wave:2:red:500:400:15,2:red:500:400:5,2:blue:500:400:15,2:blue:500:400:5
wave:5:blue:500:400:5