000000000000000000000
111111111111111111110
000000000000000000010
011111111111111111110
010000000000000000000
011111111111111111110
000000000000000000010
111111111111111111110
111111111111111111110
000000000000000000000

path:1:0:E,1:19:S,3:19:W,3:1:S,5:1:E,5:19:S,7:19:W,7:0:W
path:1:0:E,1:19:S,3:19:W,3:1:S,5:1:E,5:19:S,8:19:W,8:0:W

wave:2:basic.png:500:400:5